0
0111111111111111111111
0172222222222222222221
0122222922222222252221
0122222111111122222221
0122222100000122282221
0122222111111122222221
01252222222222200022210
0122222222222220252221
0111111111111110111111
0
