0111111111111111111
0122222222222222221
0122222111222222221
0122222141222222221
0122222111222222221
0122222151229222221
0122222111222232221
0122222161222222221
0122222111222222221
0122222181222222221
0122222111222232221
0122222171222222221
0122222111222232221
0122222222222222221
0111111111111111111