0
111111111111111111111
172222222222222222221
122222922222222252221
122222111111122222221
122222100000122282221
122222111111122222221
125222222222220002221
122222222222220252221
111111111111110111111
0
