0101010101
0112211281
0222222222
0222222222
0121
019222221
0222212221
0111112221
0227222281
0111111111