101010101
112211281
222222222
222222222
121
19222221
222212221
111112221
227222281
111111111