01111111111111111110000000111111111111111111111
019221222227222222100000001232212222222222322221
01222122211111282210000000122221222211111111221
01222162212282221110000000122111222222232721221
01242222212222222210000000128222222111111121221
01522122211111122211111111111311112122222224221
01225162227222322222222222221222262121111111111
01522122212222222211111111121211111122522224221
01223222212222222210000000121222222222222212121
01222122212211112210000000181211112211211212131
01222123222223222210000000121613211222222212121
01222122212222111110000000121211222211111222221
01112722212822382210000000122221111112821112111
01232226212222222210000000121622222222122822231
01111111111111111110000000111111111111111111111